工	a
戈	a
式	aa
芽	aah
节	ab
邛	abh
蒸	abi
芤	abn
萨	abu
匜	abv
芭	ac
茎	aca
苔	ack
苦	ad
荐	adh
藉	adij
若	adk
项	adm
藏	adn
茂	adu
功	ae
莩	aeb
获	aed
苴	aeg
菜	aes
散	aet
荽	aev
苏	aew
某	af
芸	afc
甘	afd
芈	afk
苇	afnh
著	aft
七	ag
荆	agaj
戈	agny
莱	ago
雅	ah
卧	ahnh
东	ai
范	aib
菹	aie
萍	aig
莎	aii
蔽	aim
荡	ain
荡	ainr
蒲	ais
薄	aisf
菏	aisk
落	ait
茫	aiy
划	aj
莫	ajd
菲	ajd
暮	ajdj
慕	ajdn
摹	ajdr
草	ajj
鹊	ajqg
蓝	ajr
或	ak
叵	akd
勒	ake
鞋	akf
革	akj
靼	akjg
鞂	akty
靴	akwx
苗	al
匣	alk
莲	alp
贡	am
英	amd
黄	amw
巩	amy
恐	amyn
世	an
艺	anb
蔬	anh
贳	anm
芝	ap
劳	ape
蒙	apfe
萤	apj
营	apk
荣	aps
萦	apx
警	aq
苑	aqb
敬	aqk
苟	aqk
菊	aqo
区	ar
匠	ark
欧	arq
欧	arqw
苛	ask
莆	asu
菘	asw
攻	at
医	atd
翘	atgn
莉	atj
薪	aus
切	av
艽	avb
茹	avk
共	aw
苍	awb
茯	awd
巷	awn
恭	awn
茶	aws
花	awx
药	ax
蕴	axj
蘊	axll
弋	ayi
荒	aynk
蓄	ayx
乃	b
了	b
陈	ba
陈	bai
子	bb
耶	bbh
取	bc
聚	bci
盈	bcl
娶	bcv
随	bd
承	bdi
阴	be
陆	bf
陡	bfh
际	bfi
陵	bfw
卫	bg
耳	bgh
隔	bgk
孙	bi
阳	bj
职	bk
职	bkw
阵	bl
孟	blf
出	bm
𬮿	bmn
也	bn
乃	bnt
恥	bny
耿	bo
䢊	bpd
院	bpf
隐	bq
陶	bqr
聊	bqt
陷	bqv
隐	bqvn
孤	br
孤	brcy
阿	bs
阿	bsk
降	bt
隆	bt
联	bud
陪	buk
限	bv
队	bw
附	bwf
坠	bwff
险	bwi
阶	bwj
除	bws
及	by
孩	byn
防	byt
以	c
又	c
能	c
戏	ca
劲	cae
邓	cb
骤	cbc
驰	cbn
双	cc
又	ccc
叠	cccg
桑	cccs
驿	ccf
驭	ccy
参	cd
参	cde
骑	cds
骑	cdsk
驮	cdy
能	ce
勇	cee
通	cep
劝	cet
对	cf
圣	cff
对	cfy
骊	cg
予	ci
矛	ci
预	cid
曹	cj
遭	cjp
台	ck
驯	ck
骡	cl
观	cm
马	cn
巴	cnh
驼	cp
欢	cqw
鸡	cqy
驳	cr
骄	ct
难	cw
验	cwi
难	cwy
叉	cy
驴	cyn
在	d
石	d
左	da
砸	dam
碟	dan
碟	dans
砌	dav
顾	db
友	dc
码	dcg
雄	dcw
大	dd
套	ddu
历	de
郁	deb
胡	deg
鬓	depw
夯	der
压	df
夺	df
奔	dfa
辱	dfef
夲	dfj
厈	dfk
夸	dfn
匏	dfnn
压	dfy
三	dg
感	dg
研	dga
砘	dgb
戌	dgd
古	dgh
硬	dgj
咸	dgk
感	dgkn
礓	dgl
厂	dgt
砰	dgu
威	dgv
丰	dh
存	dhb
破	dhc
慧	dhd
砋	dhg
夏	dht
泵	di
耗	die
砂	dit
耠	diw
砅	diy
百	dj
厚	djb
厞	djdd
厘	djf
右	dk
石	dkf
奋	dl
面	dl
而	dm
耐	dm
碳	dmd
布	dmh
耐	dmjf
耍	dmjv
页	dmu
成	dn
盛	dnl
灰	do
达	dp
碗	dpq
克	dq
确	dq
砥	dqa
克	dqb
确	dqe
兞	dqev
砍	dqw
原	dr
愿	dr
原	dri
愿	drin
爽	drr
厅	ds
厢	dsh
奇	dsk
帮	dt
故	dt
邦	dtb
故	dty
碰	du
砬	dug
碰	duo
碰	duog
磅	dup
肆	dv
其	dw
砼	dwa
碁	dwd
期	dwe
基	dwf
仄	dwi
泰	dwi
春	dwj
甚	dwn
欺	dwq
欺	dwqw
斯	dwr
秦	dwt
雁	dwwy
龙	dx
袭	dxye
太	dy
硫	dyc
犬	dyi
态	dyn
䃚	dytd
碎	dyw
有	e
朋	e
猎	ea
腊	eaj
猎	eajg
猫	eal
服	eb
猛	ebl
犯	ebn
肥	ec
须	ed
腌	edj
须	edm
犹	edn
月	ee
月	eee
朋	eeg
肝	ef
肢	efc
脚	efcb
膨	efk
肟	efn
脖	efp
猪	eftj
肤	efw
且	eg
助	eg
狂	egg
膈	egk
肺	egmh
用	eh
毡	ehk
胪	ehn
舟	ei
舻	eihn
盘	eil
般	eim
般	eimc
舳	eimg
船	eimk
舵	eipx
舱	eiwb
舷	eiyx
独	ej
狸	ejf
胆	ejg
刖	ejh
腥	ejt
加	ek
告	ek
郜	ekb
驾	ekc
告	ekf
加	ekg
肿	ekh
靠	ekj
靠	ekjd
臊	ekk
造	ekp
架	eks
胛	el
䐾	elff
股	emc
腨	emdj
觅	emq
力	en
甩	en
肠	enr
狄	eo
腑	eow
边	ep
受	epc
爱	epd
先	eq
胝	eqa
脆	eqd
狗	eqk
选	eqp
胸	eqr
狐	er
飖	ermr
貌	erq
采	es
彩	ese
毛	et
胜	etg
腹	etj
腹	etjt
胶	eu
腾	eu
腾	eudc
胖	euf
䏠	eug
脱	euk
膀	eup
妥	ev
狠	eve
腿	evep
舀	evf
办	ew
脸	ewi
䏩	ewkg
脂	ex
狒	exj
脂	exjg
脑	ey
狱	eyd
脉	eyn
狼	eyv
地	f
都	f
域	fa
戴	fa
哉	fak
霸	fak
哉	fakd
载	fal
栽	fas
截	faw
击	fb
去	fc
却	fcb
动	fce
劫	fce
支	fci
翅	fcn
运	fcp
魂	fcr
埃	fct
云	fcu
鼁	fcxf
城	fd
需	fd
雳	fde
需	fdm
城	fdn
堪	fdw
协	fe
霾	fej
土	ff
封	ff
卦	ffh
填	ffhw
卦	ffhy
款	ffi
䨌	ffqb
寺	ffu
墙	ffuk
二	fg
干	fg
垤	fgc
干	fgg
十	fgh
士	fghg
雨	fghy
坏	fgi
垣	fgj
坪	fgu
直	fh
起	fh
越	fha
越	fhan
趣	fhb
坡	fhc
趄	fhe
赶	fhf
址	fhg
趔	fhgj
赴	fhh
趟	fhik
起	fhn
趋	fhq
趋	fhqv
赵	fhr
走	fhu
超	fhv
超	fhvk
真	fhw
示	fi
未	fii
嫠	fitv
求	fiy
救	fiyt
进	fj
霏	fjd
朝	fje
埋	fjf
翰	fjwn
吉	fk
喜	fku
鼓	fkuc
鼙	fkuf
雷	fl
露	flt
南	fm
献	fm
圸	fmh
献	fmu
声	fn
志	fn
圮	fnn
场	fnr
声	fnr
场	fnrt
卖	fnu
卖	fnud
亏	fnv
块	fnw
专	fny
赤	fo
过	fp
勃	fpb
壶	fpo
索	fpx
元	fq
无	fq
元	fqb
顽	fqd
远	fqp
均	fqu
坎	fqw
垢	fr
埤	frt
霜	fsh
才	ft
教	ft
雾	fte
考	ftg
埏	fth
者	ftj
都	ftjb
䘄	ftjj
煮	ftjo
老	ftx
耄	ftxe
坆	fty
增	fu
幸	fuf
境	fuj
雪	fv
埽	fvp
夫	fw
替	fwf
规	fwm
鬶	fwmh
零	fwp
堆	fwy
霍	fwy
坳	fx
䨎	fxcu
㙄	fxxf
坑	fym
一	g
两	g
五	g
开	ga
形	gae
武	gah
弄	gaj
型	gajf
盏	gal
顿	gb
到	gc
至	gcf
致	gcft
天	gd
珔	gdhb
吞	gdk
珑	gdx
㺴	gdy
表	ge
青	gef
逐	gep
静	geq
于	gf
珐	gfc
玕	gfh
球	gfi
球	gfiy
𤩽	gfm
玩	gfq
王	gg
琶	ggc
琢	gge
五	ggh
环	ggi
琴	ggwo
下	gh
正	gh
正	ghd
焉	ghg
丐	ghn
璨	ghq
政	ght
政	ghty
还	gi
歪	gig
否	gik
更	gj
理	gj
惠	gjc
理	gjf
亘	gjg
瑁	gjh
丌	gjk
㻦	gjmc
更	gjr
事	gk
副	gk
吾	gkf
逼	gkl
副	gklj
逼	gklp
融	gkm
带	gkp
豆	gku
逗	gkup
事	gkv
画	gl
两	gm
现	gm
瑞	gmd
再	gmf
珮	gmg
责	gmu
两	gmww
丽	gmy
与	gn
瓦	gnn
来	go
严	god
亚	gog
恶	gogn
琮	gp
万	gq
死	gq
殛	gqb
殆	gqc
殍	gqe
殖	gqf
殖	gqfh
列	gqj
裂	gqje
烈	gqjo
迈	gqp
兀	gqv
死	gqx
丈	gr
碧	grd
珠	gri
末	gs
玫	gt
麦	gt
平	gu
夹	gud
班	gug
瓋	gum
𤧛	gup
妻	gv
珍	gw
玳	gwa
㻅	gwfc
玲	gwp
互	gx
素	gxi
毒	gxu
玉	gy
斑	gyg
上	h
止	h
虐	ha
㹏	hakg
齿	hb
龄	hbw
皮	hc
肯	he
瞬	hep
特	hf
盶	hfqn
䁄	hfuf
睦	hfw
睛	hg
睛	hge
目	hh
止	hhg
犇	hhh
卡	hhu
步	hi
督	hi
颦	hidf
旧	hj
㫖	hjf
睗	hjqr
桌	hjs
占	hk
点	hk
战	hka
虞	hkg
点	hko
卤	hlr
虎	hm
贞	hm
制	hmj
虑	hn
眠	hna
颅	hndm
凹	hnh
瞩	hnt
眯	ho
虚	hog
壑	hpgf
餐	hq
觕	hqeh
物	hqr
睁	hqv
睥	hr
睥	hrt
盯	hs
瞟	hsfi
牛	ht
睡	htf
牲	htg
瞳	hu
睇	hux
眼	hv
犍	hvf
具	hw
瞧	hwy
此	hx
些	hxf
牝	hxn
不	i
法	i
汇	ia
江	ia
浳	iae
满	iag
滢	iapy
鸿	iaq
浇	iat
洪	iaw
池	ib
汉	ic
治	ic
涌	ice
泽	icf
治	ick
汊	icy
尖	id
湖	ide
源	idr
肖	ie
潴	ief
浩	iek
洗	ieq
汗	if
法	if
法	ifc
尘	iff
汁	ifh
潮	ifje
洁	ifk
渚	iftj
潜	ifw
潜	ifwj
汪	ig
浅	iga
清	ige
沫	igs
小	ih
波	ihc
婆	ihcv
泪	ihg
涉	ihi
渺	ihit
沾	ihk
水	ii
消	iie
淼	iii
沙	iit
裟	iite
浊	ij
沓	ijf
涅	ijfg
温	ijl
漫	ijlc
湿	ijo
混	ijx
州	ik
浥	ikcn
溃	ikh
渐	il
渐	ilr
没	im
没	imc
滑	ime
油	img
溅	imga
洞	imgk
测	imj
尚	imk
沿	imk
尚	imkf
瞥	imth
沁	in
漏	inf
汤	inr
烫	inro
泥	inx
淡	io
淡	ioo
演	ip
泻	ipg
渲	ipgg
演	ipgw
沉	ipm
沈	ipq
滨	ipr
深	ipw
光	iq
沟	iqc
渔	iqgg
泡	iqn
逃	iqp
溜	iqyl
泊	ir
派	ire
汽	irn
激	iry
洒	is
漂	isf
漂	isfi
酒	isg
河	isk
淋	iss
少	it
活	itd
省	ith
汔	itn
泛	itp
涤	its
海	itx
洋	iu
溯	iub
滚	iuce
泣	iug
润	iug
滴	ium
涕	iuxt
瀁	iuye
当	iv
染	ivs
兴	iw
雀	iw
举	iwf
浍	iwfc
澄	iwg
澄	iwgu
涂	iws
浴	iwwk
誉	iwy
雀	iwyf
涨	ixt
游	iy
淳	iyb
流	iyc
注	iyg
济	iyj
湾	iyo
湾	iyox
浒	iyt
浪	iyv
液	iyw
淬	iywf
是	j
里	j
虹	ja
晓	jat
暴	jaw
最	jb
紧	jc
坚	jcf
竖	jcu
非	jd
䘈	jdae
悲	jdd
辈	jddl
悲	jddn
晨	jdf
明	je
暖	jeg
勗	jege
盟	jel
暧	jepc
㿢	jerf
时	jf
里	jf
野	jfc
里	jfd
蛙	jff
旱	jfj
量	jg
题	jg
昊	jgd
旦	jgf
旺	jgg
虾	jgh
韪	jghh
题	jghm
师	jgm
冒	jh
早	jh
勖	jhe
虫	jhn
曰	jhng
晃	ji
日	jj
昌	jjf
晶	jjj
蝇	jk
蜗	jkm
曙	jl
螺	jlx
遇	jm
愚	jmcn
蚰	jmg
电	jn
虬	jnn
昵	jnx
旷	jo
显	jo
晖	jpl
晚	jq
昂	jqb
易	jqr
易	jqrr
临	jr
临	jrj
监	jrl
螝	jrqc
果	js
颗	jsd
颗	jsdm
晒	jsg
昨	jt
星	jtg
蝮	jtj
虼	jtn
暗	ju
蛟	jur
归	jv
照	jv
蛝	jvey
昭	jvk
照	jvko
蚧	jwj
影	jy
景	jyi
中	k
吗	k
呀	ka
哄	kaw
嗒	kawk
啊	kb
叩	kbh
吼	kbn
吸	kby
吧	kc
邑	kcb
嗓	kccs
吗	kcg
吧	kcn
唉	kct
叹	kcy
喊	kd
嘎	kdh
嗄	kdht
顺	kdm
另	ke
别	kej
别	kejh
嚼	kel
叶	kf
吱	kfc
嗑	kfcl
哇	kff
吐	kfg
味	kfi
鄙	kfl
鄙	kflb
嘟	kftb
呈	kg
吴	kgd
吓	kgh
啧	kgm
号	kgn
嗷	kgqt
贵	kh
遗	kh
啅	khjh
忠	khn
嘴	khx
吵	kit
虽	kj
哩	kjf
唱	kjj
喝	kjq
虽	kju
口	kk
哭	kkd
器	kkd
串	kkh
患	kkhn
品	kkk
嗯	kl
嘿	klfo
呷	klh
啰	klq
员	km
喘	kmd
叽	kmn
叫	kn
哪	knf
叼	kng
唰	knm
嘱	knt
呢	knx
嘛	kos
喽	kov
兄	kq
嘝	kqef
唤	kqm
咆	kqn
呜	kqng
吹	kqw
鸣	kqy
听	kr
史	kri
啪	krr
啦	kru
呆	ks
呼	kt
川	kt
噬	kta
咱	kth
嗅	kthd
咋	kthf
川	kthh
喒	kthj
咯	ktkg
响	ktm
吃	ktn
哦	ktr
咚	ktu
啼	ku
噌	kulj
咬	kur
叨	kv
哏	kve
嘯	kvf
只	kw
呛	kwb
嗡	kwc
喻	kwej
咐	kwf
啥	kwfk
哈	kwk
叭	kwy
唯	kwyg
叱	kxn
吭	kym
嚎	kype
嗾	kytd
国	l
足	l
距	lan
轻	lc
轻	lca
踊	lce
因	ld
固	ldd
恩	ldn
蹶	ldu
男	le
㘞	lee
胃	lef
踩	les
蹈	lev
轩	lf
罢	lfc
置	lfh
转	lfn
围	lfnh
黑	lfo
默	lfod
黗	lfon
黢	lfot
园	lfq
团	lft
圉	lfu
车	lg
囤	lgb
畏	lge
罡	lgh
辆	lgm
车	lgn
四	lh
躩	lhhc
足	lhn
跳	li
踏	lij
踢	lj
罪	ljd
回	lk
圆	lkm
迴	lkp
田	ll
㘡	llk
轴	lm
蹦	lme
蹦	lmee
思	ln
踞	lnd
连	lp
罗	lq
软	lq
蜀	lqj
跑	lqn
软	lqw
跌	lrw
困	ls
辅	ls
路	lt
跃	ltd
略	ltk
图	ltu
较	lu
圈	lud
圈	ludb
蹄	lup
跤	lur
蹲	lus
蹲	lusf
轨	lv
跟	lve
轨	lvn
趴	lw
输	lw
界	lwj
轮	lwx
趴	lwy
累	lxi
同	m
曲	ma
央	md
骨	me
髑	mel
财	mf
冉	mfd
周	mfk
财	mft
赋	mg
贱	mga
同	mgk
帖	mh
由	mh
幅	mhg
帽	mhj
帽	mhjh
巾	mhk
贴	mhk
贴	mhkg
帐	mht
幢	mhu
则	mj
赐	mjq
删	mm
山	mm
册	mmg
删	mmgj
山	mmm
岂	mn
迪	mp
见	mq
岁	mqu
峥	mqv
风	mr
刚	mrj
嵬	mrq
网	mrr
朵	ms
几	mt
峰	mtd
败	mty
㠉	mujf
内	mw
肉	mww
幽	mx
凡	my
彤	mye
心	n
羽	n
惜	na
民	na
展	nae
异	naj
羿	naj
惜	najg
怄	nar
懂	nat
殿	naw
慌	nay
屈	nb
敢	nb
屈	nbm
忚	nbn
发	nc
惨	ncd
怪	ncf
悛	ncwt
居	nd
剧	ndj
忧	ndn
尾	ne
导	nf
那	nf
愤	nfa
那	nfb
层	nfc
怯	nfcy
丑	nfd
恃	nff
恃	nffy
卂	nfk
司	ng
情	ng
屋	ngc
情	nge
䍿	ngf
怔	ngh
怀	ngi
恒	ngj
悟	ngk
收	nh
眉	nhd
蛋	nhj
收	nht
疏	nhyk
慢	nj
惺	njt
避	nk
臂	nkue
壁	nkuf
擘	nkur
璧	nkuy
譬	nkuy
翼	nl
翼	nla
翼	nlaw
愣	nly
届	nm
刷	nmh
已	nn
忸	nnf
己	nng
尸	nngt
书	nnh
局	nnk
忆	nnn
快	nnw
懈	nq
懈	nqe
惚	nqr
怕	nr
愧	nr
忷	nrbh
怕	nrg
惶	nrg
愧	nrq
必	nt
必	nte
性	ntg
属	ntk
愀	nto
履	ntt
改	nty
习	nu
屏	nua
买	nud
飞	nui
悦	nukq
憎	nul
恨	nv
慨	nv
恨	nve
怜	nw
忪	nwc
恰	nwk
惟	nwy
惟	nwyg
尼	nx
惯	nxm
忙	ny
惊	ny
尺	nyi
惊	nyi
惊	nyiy
懔	nyl
迟	nyp
㤃	nyt
尽	nyu
尽	nyuu
翠	nyw
为	o
觉	o
度	oa
席	oam
烧	oat
学	ob
序	oc
序	oci
糟	ocj
类	od
烣	odoy
燎	odu
庄	of
尝	ofc
庤	offi
业	og
精	og
精	oge
凿	ogu
店	oh
粘	ohk
应	oi
炒	oit
爆	oj
爆	oja
焊	ojf
常	ok
堂	okf
赏	okm
党	okq
掌	okr
库	ol
烟	old
庙	om
灿	om
籼	omh
觉	omq
断	on
熠	onr
火	oo
焱	oo
焱	ooo
糖	oov
迷	op
煊	opg
底	oq
粼	oql
炮	oqn
床	os
灯	osh
爩	osre
磨	ossd
庭	ot
炸	othf
熄	othn
敉	oty
粒	ou
烂	oud
料	ouf
糕	oug
数	ov
㶢	ovb
庸	oveh
唐	ovh
康	ovi
数	ovt
腐	ow
府	owf
粉	owv
座	oww
座	owwf
鹿	ox
麋	oxxo
广	oy
炉	oyn
米	oyt
粮	oyv
廊	oyvb
之	p
家	p
宽	pa
字	pb
字	pbf
㝋	pbj
赛	pc
赛	pcm
寒	pcu
害	pd
割	pdh
寄	pdsk
寮	pdu
农	pe
宜	peg
守	pf
宗	pfi
完	pfq
定	pg
室	pgc
宇	pgf
宣	pgj
富	pgk
富	pgkl
写	pgn
宝	pgy
牢	ph
审	pj
宴	pjv
宫	pk
宫	pkk
军	pl
寰	plge
宙	pm
官	pn
密	pnt
灾	po
之	pp
之	ppp
宛	pq
宁	ps
客	pt
被	pu
衩	puc
实	pud
衫	pue
补	puh
裆	pui
宰	puj
袖	pum
袂	punw
襟	pusi
初	puv
褪	puvp
安	pv
宄	pvb
案	pvs
空	pw
穿	pwa
窍	pwan
突	pwd
穷	pwe
罕	pwf
察	pwfi
窝	pwk
窜	pwkh
窗	pwt
窄	pwtf
窸	pwtn
窨	pwuj
究	pwv
窘	pwvk
容	pww
鹤	pwy
窣	pwyf
它	px
礼	py
祓	pydy
祖	pye
社	pyf
祛	pyfc
福	pyg
祯	pyh
神	pyj
视	pym
礼	pyn
祈	pyr
祥	pyu
禅	pyuf
多	q
然	q
错	q
昏	qa
氏	qa
错	qaj
迎	qb
怨	qbn
迎	qbp
勾	qc
色	qc
钗	qcy
然	qd
危	qdb
锲	qdhd
铖	qdn
厃	qdr
铸	qdtf
角	qe
锆	qek
解	qev
针	qf
镇	qfh
钱	qg
印	qgb
鱼	qgf
鳄	qgk
鲍	qgqn
鲜	qgu
外	qh
乐	qi
销	qie
锁	qim
钞	qit
尔	qiu
名	qk
够	qk
句	qkd
象	qke
名	qkf
锃	qkg
钏	qkh
钟	qkhh
锅	qkm
免	qkq
勉	qkqe
钾	ql
钿	qlg
负	qm
包	qn
饶	qna
饴	qnc
乌	qng
饥	qnm
馆	qnp
饮	qnq
饱	qnqn
饮	qnqw
饭	qnr
饭	qnrc
饿	qnt
饼	qnua
炙	qo
鰕	qonc
锭	qp
金	qq
钩	qqc
铆	qqtb
钓	qqy
铁	qr
匈	qrb
忽	qrn
铁	qrw
钉	qs
铺	qs
儿	qt
锺	qtg
夕	qtn
匀	qu
孵	qubb
钭	quf
镁	qug
锌	quh
镜	quj
铲	qut
镒	quw
银	qv
键	qv
银	qve
争	qvh
急	qvn
煞	qvto
欠	qw
铪	qwk
铃	qwp
锴	qx
久	qy
勺	qyi
袅	qyne
鸟	qyng
贸	qyv
鎯	qyvb
锒	qyve
留	qyvl
贸	qyvm
鶹	qyvo
把	r
的	r
找	ra
拭	raa
摸	rajd
拒	ran
拣	ranw
捞	rap
挠	rat
搭	rawk
报	rb
拙	rbm
扔	rbt
反	rc
把	rc
掺	rcd
抒	rci
揉	rcis
抬	rck
挨	rct
摊	rcw
瓜	rcy
搔	rcyj
拜	rd
肴	rde
掩	rdj
希	rdm
揍	rdwd
撕	rdwr
拢	rdx
摇	re
搬	rei
搬	reic
授	rep
摇	rer
持	rf
技	rfc
挂	rff
盾	rfh
质	rfm
扝	rfnn
扶	rfw
后	rg
皇	rg
邱	rgb
皇	rgf
扌	rgh
抹	rgs
挟	rgu
挟	rgud
兵	rgw
看	rh
卸	rhb
披	rhc
掳	rhe
看	rhf
扯	rhg
掉	rhj
扑	rhy
爪	rhy
爬	rhyc
爪	rhyi
朱	ri
挑	riq
提	rj
撮	rjb
排	rjd
捏	rjf
担	rjg
刈	rjh
揽	rjr
扣	rk
拐	rke
捐	rke
操	rkk
操	rkks
损	rkm
押	rl
摁	rldn
摆	rlf
舞	rlg
捆	rls
捆	rlsy
抽	rm
缸	rma
投	rmc
揣	rmd
缺	rmn
所	rn
气	rnb
氢	rnc
拨	rncy
据	rnd
捤	rne
扭	rnf
握	rng
扎	rnn
扬	rnr
氧	rnu
探	rp
近	rp
迫	rpd
皖	rpf
挥	rpl
按	rpv
控	rpw
搾	rpwf
擦	rpwi
挖	rpwn
探	rpws
抱	rq
换	rq
抵	rqa
鬼	rqc
撸	rqg
㧰	rqi
抱	rqn
兜	rqnq
揿	rqq
挣	rqv
掐	rqv
挣	rqvh
欣	rqw
捣	rqy
白	rr
扳	rrc
拍	rrg
折	rrh
抓	rrhy
蜇	rrj
逝	rrp
白	rrr
拆	rry
誓	rryf
打	rs
杀	rs
搮	rssy
杀	rsu
手	rt
挺	rt
托	rta
拖	rtb
插	rtf
攥	rth
乂	rty
拉	ru
拼	rua
搠	rub
掷	rudb
撞	ruj
摘	rum
撙	rus
搁	rut
搁	rutk
接	ruv
扫	rv
热	rv
抛	rve
拫	rvey
招	rvk
势	rvy
执	rvy
势	rvye
热	rvyo
失	rw
推	rw
抢	rwb
捡	rwi
拾	rwk
拎	rwp
迭	rwp
扒	rwy
推	rwyg
批	rx
指	rx
指	rxj
批	rxx
搞	ry
挤	ryj
抗	rym
护	ryn
邀	ryt
摔	ryx
西	s
要	s
械	saa
杠	sag
框	sagg
模	saj
榧	sajd
横	sam
横	samw
李	sb
极	sby
权	sc
桶	sce
树	scf
顶	sdm
杉	se
棚	see
杉	set
村	sf
枝	sfc
桂	sff
杆	sfh
植	sfhg
标	sfi
飘	sfir
票	sfiu
桔	sfk
㮦	sfpi
材	sft
本	sg
栈	sga
酏	sgb
酸	sgc
酾	sggy
丁	sgh
杯	sgi
醒	sgj
配	sgn
酌	sgq
醉	sgy
醇	sgyb
醉	sgyf
想	sh
相	sh
椒	shic
棹	shj
想	shn
檙	shnn
朴	shy
桃	si
档	siv
查	sj
榻	sjn
可	sk
歌	sk
束	skd
杏	skf
榀	skk
速	skp
赖	skqm
哥	sks
整	skt
柬	sl
楞	sl
机	sm
桐	smgk
杣	smh
刺	smj
樱	smmv
枫	smr
杨	sn
栩	sng
杨	snr
杨	snrt
杰	so
粟	sou
楼	sov
枕	sp
枕	spq
构	sq
柳	sq
构	sqc
檐	sqdy
柳	sqt
析	sr
板	src
株	sri
棉	srm
棉	srmh
木	ss
森	ss
禁	ssf
梵	ssm
楚	ssn
梦	ssq
森	sss
林	ssy
桥	st
桥	std
格	stk
梅	stx
枚	sty
样	su
槎	sua
校	sur
樽	susf
根	sv
概	sva
根	sve
楗	svf
枪	sw
检	sw
松	swc
检	swi
樵	swyo
楷	sx
术	sy
椁	syb
核	syn
和	t
我	t
长	ta
䇫	tahh
升	tak
筑	tam
彻	tav
长	tay
秀	tb
䄦	tbh
彵	tbn
透	tbp
么	tc
私	tc
径	tca
笃	tcf
私	tcy
知	td
短	tdg
箴	tdgk
短	tdgu
逢	tdh
籍	tdij
乔	tdj
刮	tdjh
知	tdk
智	tdkj
岙	tdm
乱	tdn
适	tdp
矮	tdtv
㣕	tdy
务	te
笔	te
笔	teb
租	teg
笳	tek
稻	tev
待	tf
等	tf
垂	tfa
丢	tfc
壬	tfd
竺	tff
街	tffs
待	tffy
徒	tfhy
午	tfj
千	tfk
德	tfl
䈒	tfmf
箸	tft
箸	tftj
穑	tfuk
生	tg
行	tg
笺	tga
生	tgd
箐	tge
彺	tgg
征	tgh
重	tgj
穗	tgjn
衙	tgk
熏	tgl
箦	tgm
行	tgs
处	th
怎	th
算	tha
彼	thc
自	thd
臭	thdu
乍	thf
怎	thfn
片	thg
版	thgc
牌	thgf
牗	thgh
片	thgn
昝	thj
咎	thk
鼻	thl
鼻	thlj
息	thn
延	thp
臬	ths
竹	tht
竹	thth
秒	ti
稍	tie
筄	tiqb
箔	tir
利	tj
得	tj
香	tjf
筛	tjg
利	tjh
犁	tjh
梨	tjs
复	tjt
各	tk
和	tk
各	tkf
程	tkg
种	tkh
稆	tkk
积	tkw
备	tl
年	tl
血	tld
备	tlf
箅	tlg
惫	tln
衅	tlu
向	tm
身	tmd
射	tmdf
躰	tmdg
躺	tmdk
躲	tmds
身	tmdt
秧	tmdy
笛	tmf
筒	tmg
筒	tmgk
币	tmh
微	tmm
奥	tmo
奥	tmod
秽	tmq
追	tn
帥	tnmh
筷	tnn
筷	tnnw
秘	tnt
秋	to
释	toc
释	tocf
番	tol
翻	toln
乏	tp
管	tp
移	tq
称	tqi
笱	tqk
稳	tqv
稀	trd
御	trh
穆	tri
筘	trk
条	ts
笨	tsg
箱	tsh
策	tsm
禾	tt
笑	ttd
剩	tu
科	tu
笠	tuf
乎	tufk
徉	tuh
简	tuj
税	tuk
冬	tuu
乘	tux
剩	tuxj
委	tv
很	tve
律	tvf
箫	tvi
笋	tvt
答	tw
符	twf
签	twi
答	twk
徐	tws
每	tx
龜	txd
第	txh
系	txi
繁	txti
入	ty
往	tyg
篇	tyn
籇	type
彷	tyt
稂	tyve
着	u
门	u
并	ua
疟	ua
差	uaf
瓶	uag
冻	uai
闻	ub
疗	ubk
瘾	ubq
槊	ubts
痛	uc
痛	uce
冯	ucg
瘫	ucwy
关	ud
头	ud
卷	udb
郑	udb
兰	udf
减	udg
头	udi
送	udp
凑	udw
状	udy
前	ue
瘢	uei
煎	uejo
剪	uejv
痈	uek
遂	uep
半	uf
斗	uf
闺	uff
疛	ufi
判	ufj
斗	ufk
凌	ufw
装	ufy
美	ug
闰	ug
闰	ugd
靖	uge
症	ugh
竱	ugjf
盖	ugl
病	ugm
羹	ugod
羡	ugu
姜	ugv
姜	ugvf
站	uh
冰	ui
阔	ui
䦢	uifc
阔	uit
单	uj
间	uj
鄣	ujb
童	ujf
音	ujf
㾖	ujfd
章	ujj
意	ujn
竟	ujq
竭	ujqn
韶	ujv
况	uk
问	uk
部	ukb
冲	ukh
癌	ukk
䍺	ukkn
总	ukn
竞	ukq
况	ukqn
曾	ul
闸	ul
商	um
端	umd
瘿	umm
疯	umr
决	un
闷	un
翔	ung
爿	unh
决	unw
普	uo
帝	up
旁	up
旁	upy
次	uq
资	uq
将	uqf
桨	uqs
酱	uqsg
净	uqv
次	uqw
盗	uqwl
交	ur
郊	urb
效	urt
亲	us
尊	usgf
遵	usgp
闲	usi
辣	usk
阑	usl
新	usr
凇	usw
道	ut
产	ute
颜	utem
癪	utgm
首	uth
癟	utha
阁	utk
疼	utu
䍩	uty
善	uu
立	uu
阙	uub
阅	uukq
辨	uuu
妆	uv
痕	uv
痕	uve
妆	uvg
瘦	uvhc
兼	uvo
闪	uw
疮	uwb
瘵	uwf
痊	uwg
疥	uwj
益	uwl
冷	uwp
准	uwy
北	ux
背	uxe
弟	uxh
递	uxhp
凝	uxt
六	uy
凉	uy
门	uyh
凉	uyiy
养	uyj
闹	uymh
羊	uyt
她	v
好	v
妇	v
既	va
好	vb
即	vbh
奴	vc
妈	vc
孥	vcb
努	vce
始	vck
怒	vcn
姑	vd
姐	ve
媛	veg
退	vep
寻	vf
建	vf
妹	vfi
建	vfp
录	vi
剥	vij
肃	vij
逮	vip
妙	vit
旭	vj
召	vk
如	vk
邕	vkc
娟	vke
娱	vkgd
舅	vl
姗	vm
刀	vn
媚	vnh
妮	vnx
灵	vo
巡	vp
婃	vpfi
嫔	vpr
杂	vs
九	vt
群	vt
妖	vtd
娇	vtdj
尹	vte
姓	vtg
君	vtk
群	vtk
群	vtku
娥	vtr
嫌	vu
女	vv
妇	vvg
臾	vw
妨	vyt
娘	vyv
人	w
作	w
俗	w
代	wa
仝	waf
借	waj
黛	wal
供	waw
他	wb
创	wbj
仍	wbt
伋	wby
公	wc
俟	wctd
仅	wcy
估	wd
佑	wdk
段	wdm
优	wdn
倚	wds
做	wdt
伏	wdy
偁	wemf
会	wf
值	wf
会	wfc
郐	wfcb
儒	wfd
佳	wff
侍	wffy
仁	wfg
什	wfh
値	wfhn
传	wfn
佬	wft
佬	wftx
付	wfy
全	wg
伅	wgb
倒	wgc
倒	wgcj
全	wgf
佂	wghg
便	wgj
使	wgk
登	wgku
僵	wgl
兮	wgn
例	wgq
例	wgqj
个	wh
件	wh
仩	whg
件	whh
倬	whj
候	whn
修	wht
悠	whtn
俱	whw
剑	wi
剑	wij
倘	wim
倘	wimk
佻	wiq
氽	wiu
介	wj
但	wj
但	wjg
但	wjgg
伸	wjh
偶	wjm
倮	wjs
合	wk
命	wkb
颌	wkd
俣	wkg
仲	wkh
侣	wkk
盒	wkl
翕	wkn
鸽	wkq
拿	wkr
保	wks
促	wl
偎	wl
仙	wm
偳	wmdj
侧	wmj
亿	wn
假	wnh
似	wny
今	wo
伙	wo
今	wob
偿	wof
㪁	wohc
含	wok
贪	wom
念	won
衾	woye
令	wp
邻	wpb
僿	wpcf
领	wpd
领	wpdm
你	wq
低	wqa
您	wqi
侚	wqj
像	wqk
偬	wqr
㐴	wqy
伯	wr
爸	wrc
斧	wrr
俾	wrt
父	wru
休	ws
傅	wsf
体	wsg
何	wsk
途	wsp
余	wsu
斜	wsuf
偠	wsv
休	wsy
八	wt
凭	wt
仫	wtc
伤	wte
任	wtf
俐	wtj
傻	wtl
八	wty
们	wu
伴	wuf
位	wug
倍	wuk
僧	wul
佼	wur
㑵	wutd
分	wv
邠	wvb
伮	wvc
饢	wvk
侵	wvp
䬷	wvqq
从	ww
耸	wwb
偷	wwe
坐	wwf
丛	wwg
价	wwj
谷	wwk
欲	wwkw
仌	wwu
份	wwv
众	www
俗	wwwk
伦	wwx
化	wx
倾	wxd
华	wxf
僶	wxg
伄	wxh
佛	wxj
货	wxm
信	wy
禽	wy
隽	wyb
隻	wyc
依	wye
住	wyg
售	wyk
偏	wyn
停	wyp
仪	wyr
集	wys
仿	wyt
亽	wyu
食	wyv
母	x
经	x
红	xa
练	xan
级	xby
弘	xc
绑	xd
顷	xdm
幼	xe
组	xe
缓	xeg
结	xf
续	xfn
绪	xft
线	xg
纯	xgb
纡	xgf
引	xh
旨	xj
费	xj
费	xjm
费	xjmu
缆	xjr
强	xk
绳	xkj
织	xkw
细	xl
纳	xmw
纪	xn
幻	xnn
缪	xnw
继	xo
缠	xoj
缕	xov
缩	xpw
绝	xq
纸	xqa
绝	xqc
弥	xqi
约	xqy
缴	xr
弧	xrc
弧	xrcy
绵	xrmh
缚	xs
张	xt
疑	xtd
缝	xtdp
乡	xte
终	xtu
縦	xtuh
弱	xu
绊	xuf
弹	xuj
绿	xvi
纨	xvy
给	xw
绘	xwf
给	xwk
纷	xwv
纵	xww
绤	xwwk
维	xwy
比	xx
缘	xxe
毕	xxf
丝	xxg
皆	xxr
幺	xxx
编	xy
统	xyc
纹	xyy
该	y
这	y
试	ya
诺	yadk
谎	yay
享	yb
熟	ybv
充	yc
弃	yca
育	yce
诵	yceh
言	yd
言	ydk
诚	ydn
衣	ye
哀	yeu
计	yf
诗	yff
讲	yfj
读	yfn
讨	yfy
主	yg
主	ygd
请	yge
证	ygh
语	ygk
謮	ygm
评	ygu
让	yh
就	yi
京	yiu
刘	yj
齐	yjj
谩	yjlc
课	yjs
裹	yjse
训	yk
识	yk
误	ykg
误	ykgd
识	ykw
亩	yl
谓	yl
谓	yle
亩	ylf
市	ym
高	ym
设	ymc
颃	ymd
调	ymf
调	ymfk
䛆	ymg
讪	ymh
市	ymhj
记	yn
䛯	yndg
户	yne
肩	yned
望	yneg
讯	ynf
诩	yng
词	yngk
盲	ynh
永	yni
启	ynk
扁	ynm
遍	ynm
扁	ynma
扃	ynmk
忘	ynn
扇	ynnd
謵	ynr
謵	ynrg
刻	ynt
颏	yntm
妄	ynvf
诀	ynw
房	yny
亦	yo
变	yoc
恋	yon
谈	yoo
爕	yooo
谜	yopy
弯	yox
亮	yp
毫	ype
询	yqj
义	yr
离	yrb
诛	yri
诉	yry
订	ys
放	yt
施	yt
施	ytb
话	ytd
旅	yte
许	ytf
䚾	ytfg
旐	yti
谢	ytm
旋	ytn
族	ytt
旌	yttg
放	yty
说	yu
谫	yue
详	yuh
谱	yuo
良	yv
郎	yvb
认	yw
诊	ywe
夜	ywt
卒	ywwf
论	ywx
谁	ywy
率	yx
文	yy
方	yy
文	yyg
文	yygy
该	yyn
议	yyr
访	yyt
詃	yyx
方	yyy